###########################
#  P                      #
#                         #
#            X            #
#                         #
#                         #
#                         #
###########################