###########################
# #P      #               #
#          #              #
#            X            #
#                         #
#                         #
#                         #
###########################